<s>	sil
</s>	sil
MATIKAN	m aa t ih k aa n 
BATALKAN	b aa t aa l k aa n
PASANG	p aa s aa ng
ALARM	aa l aa r m
PUKUL	p uw k uw l
SATU	s aa t uw
DUA	d uw aa
TIGA	t ih g aa
EMPAT	ah m p aa t
LIMA	l ih m aa
ENAM	ah n aa m
TUJUH	t uw jh uw hh
DELAPAN	d ah l aa p aa n
SEMBILAN	s ah m b ih l aa n
SEPULUH	s ah p uw l uw hh
SEBELAS	s ah b ah l aa s
DUABELAS	d uw aa b ah l aa s
PAGI	p aa g ih
SIANG	s ih aa ng
SORE	s ao r eh
MALAM	m aa l aa m